1111111111111
1P110C00000C1
11E0011111001
1000111000001
1111111111111