11111111111111111111111111111111111111111111111111111111111111111111111111111111111111111111111111111111111111111111111111111111111111111111111111111111111111111111111111111111111111111111111111111111111111111111111111111111111111111111111111111111111111111111111111111111111
100C00C00C00C00C00C00C00C00C00C00C00C00C00C00C00C00C00C00C00C00C00C00C00C00C00C00C00C00C00C00C00C00C00C00C0C00C00C00C00C00C00C00C00C00C00C00C00C00C00C00C00C00C00C00C00C00C00C00C00C00C00C00C00C00C00C00C00C00C00C0C00C00C00C00C00C00C00C00C00C00C00C00C00C00C00C00C00C00C00C00C001
11E11100C00C00C00C00C00C00C00C00C00C00C00C00C00C00C00C00C00C00C00C00C00C00C00C00C00C00C00C00C00C00C00C00C00C00C0C00C00C00C00C00C00C00C00C00C00C00C00C00C00C00C00C00C00C00C00C00C00C00C00C00C00C00C00C00C00C00C00C00C00C0C00C00C00C00C00C00C00C00C00C00C00C00C00C00C00C00C00C00C00C1
10011111100C00C00C00C00C00C00C00C00C00C00C00C00C00C00C00C00C00C00C00C00C00C00C00C00C00C00C00C00C00C00C00C00C00C00C0C00C00C00C00C00C00C00C00C00C00C00C00C00C00C00C00C00C00C00C00C00C00C00C00C00C00C00C00C00C00C00C00C00C00C0C00C00C00C00C00C00C00C00C00C00C00C00C00C00C00C00C00C0111
100C00C00C00C00C00C00C00C00C00C00C00C00C00C00C00C00C00C00C00C00C00C00C00C00C00C00C00C00C00C00C00C00C00C00C0C00C00C00C00C00C00C00C00C00C00C00C00C00C00C00C00C00C00C00C00C00C00C00C00C00C00C00C00C00C00C00C00C00C00C0C00C00C00C00C00C00C00C00C00C00C00C00C00C00C00C00C00C00C00C00C001
100C00C00C00C00C00C00C00C00C00C00C00C00C00C00C00C00C00C00C00C00C00C00C00C00C00C00C00C00C00C00C00C00C00C00C0C00C00C00C00C00C00C00C00C00C00C00C00C00C00C00C00C00C00C00C00C00C00C00C00C00C00C00C00C00C00C00C00C00C00C0C00C00C00C00C00C00C00C00C00C00C00C00C00C00C00C00C00C00C00C00C001
100C00C00C00C00C00C00C00C00C00C00C00C00C00C00C00C00C00C00C00C00C00C00C00C00C00C00C00C00C00C00C00C00C00C00C0C00C00C00C00C00C00C00C00C00C00C00C00C00C00C00C00C00C00C00C00C00C00C00C00C00C00C00C00C00C00C00C00C00C00C0C00C00C00C00C00C00C00C00C00C00C00C00C00C00C00C00C00C00C00C00C001
100C00C00C00C00C00C00C00C00C00C00C00C00C00C00C00C00C00C00C00C00C00C00C00C00C00C00C00C00C00C00C00C00C00C00C0C00C00C00C00C00C00C00C00C00C00C00C00C00C00C00C00C00C00C00C00C00C00C00C00C00C00C00C00C00C00C00C00C00C00C0C00C00C00C00C00C00C00C00C00C00C00C00C00C00C00C00C00C00C00C00C001
100C00C00C00C00C00C00C00C00C00C00C00C00C00C00C00C00C00C00C00C00C00C00C00C00C00C00C00C00C00C00C00C00C00C00C0C00C00C00C00C00C00C00C00C00C00C00C00C00C00C00C00C00C00C00C00C00C00C00C00C00C00C00C00C00C00C00C00C00C00C0C00C00C00C00C00C00C00C00C00C00C00C00C00C00C00C00C00C00C00C00C001
100C00C00C00C00C00C00C00C00C00C00C00C00C00C00C00C00C00C00C00C00C00C00C00C00C00C00C00C00C00C00C00C00C00C00C0C00C00C00C00C00C00C00C00C00C00C00C00C00C00C00C00C00C00C00C00C00C00C00C00C00C00C00C00C00C00C00C00C00C00C0C00C00C00C00C00C00C00C00C00C00C00C00C00C00C00C00C00C00C00C00C001
100C00C00C00C00C00C00C00C00C00C00C00C00C00C00C00C00C00C00C00C00C00C00C00C00C00C00C00C00C00C00C00C00C00C00C0C00C00C00C00C00C00C00C00C00C00C00C00C00C00C00C00C00C00C00C00C00C00C00C00C00C00C00C00C00C00C00C00C00C00C0C00C00C00C00C00C00C00C00C00C00C00C00C00C00C00C00C00C00C00C00C001
100C00C00C00C00C00C00C00C00C00C00C00C00C00C00C00C00C00C00C00C00C00C00C00C00C00C00C00C00C00C00C00C00C00C00C0C00C00C00C00C00C00C00C00C00C00C00C00C00C00C00C00C00C00C00C00C00C00C00C00C00C00C00C00C00C00C00C00C00C00C0C00C00C00C00C00C00C00C00C00C00C00C00C00C00C00C00C00C00C00C00C001
100C00C00C00C00C00C00C00C00C00C00C00C00C00C00C00C00C00C00C00C00C00C00C00C00C00C00C00C00C00C00C00C00C00C00C0C00C00C00C00C00C00C00C00C00C00C00C00C00C00C00C00C00C00C00C00C00C00C00C00C00C00C00C00C00C00C00C00C00C00C0C00C00C00C00C00C00C00C00C00C00C00C00C00C00C00C00C00C00C00C00C001
100C00C00C00C00C00C00C00C00C00C00C00C00C00C00C00C00C00C00C00C00C00C00C00C00C00C00C00C00C00C00C00C00C00C00C0C00C00C00C00C00C00C00C00C00C00C00C00C00C00C00C00C00C00C00C00C00C00C00C00C00C00C00C00C00C00C00C00C00C00C0C00C00C00C00C00C00C00C00C00C00C00C00C00C00C00C00C00C00C00C00C001
100C00C00C00C00C00C00C00C00C00C00C00C00C00C00C00C00C00C00C00C00C00C00C00C00C00C00C00C00C00C00C00C00C00C00C0C00C00C00C00C00C00C00C00C00C00C00C00C00C00C00C00C00C00C00C00C00C00C00C00C00C00C00C00C00C00C00C00C00C00C0C00C00C00C00C00C00C00C00C00C00C00C00C00C00C00C00C00C00C00C00C001
100C00C00C00C00C00C00C00C00C00C00C00C00C00C00C00C00C00C00C00C00C00C00C00C00C00C00C00C00C00C00C00C00C00C00C0C00C00C00C00C00C00C00C00C00C00C00C00C00C00C00C00C00C00C00C00C00C00C00C00C00C00C00C00C00C00C00C00C00C00C0C00C00C00C00C00C00C00C00C00C00C00C00C00C00C00C00C00C00C00C00C001
100C00C00C00C00C00C00C00C00C00C00C00C00C00C00C00C00C00C00C00C00C00C00C00C00C00C00C00C00C00C00C00C00C00C00C0C00C00C00C00C00C00C00C00C00C00C00C00C00C00C00C00C00C00C00C00C00C00C00C00C00C00C00C00C00C00C00C00C00C00C0C00C00C00C00C00C00C00C00C00C00C00C00C00C00C00C00C00C00C00C00C001
100C00C00C00C00C00C00C00C00C00C00C00C00C00C00C00C00C00C00C00C00C00C00C00C00C00C00C00C00C00C00C00C00C00C00C0C00C00C00C00C00C00C00C00C00C00C00C00C00C00C00C00C00C00C00C00C00C00C00C00C00C00C00C00C00C00C00C00C00C00C0C00C00C00C00C00C00C00C00C00C00C00C00C00C00C00C00C00C00C00C00C001
100C00C00C00C00C00C00C00C00C00C00C00C00C00C00C00C00C00C00C00C00C00C00C00C00C00C00C00C00C00C00C00C00C00C00C0C00C00C00C00C00C00C00C00C00C00C00C00C00C00C00C00C00C00C00C00C00C00C00C00C00C00C00C00C00C00C00C00C00C00C0C00C00C00C00C00C00C00C00C00C00C00C00C00C00C00C00C00C00C00C00C001
100C00C00C00C00C00C00C00C00C00C00C00C00C00C00C00C00C00C00C00C00C00C00C00C00C00C00C00C00C00C00C00C00C00C00C0C00C00C00C00C00C00C00C00C00C00C00C00C00C00C00C00C00C00C00C00C00C00C00C00C00C00C00C00C00C00C00C00C00C00C0C00C00C00C00C00C00C00C00C00C00C00C00C00C00C00C00C00C00C00C00C001
100C00C00C00C00C00C00C00C00C00C00C00C00C00C00C00C00C00C00C00C00C00C00C00C00C00C00C00C00C00C00C00C00C00C00C0C00C00C00C00C00C00C00C00C00C00C00C00C00C00C00C00C00C00C00C00C00C00C00C00C00C00C00C00C00C00C00C00C00C00C0C00C00C00C00C00C00C00C00C00C00C00C00C00C00C00C00C00C00C00C00C001
100C00C00C00C00C00C00C00C00C00C00C00C00C00C00C00C00C00C00C00C00C00C00C00C00C00C00C00C00C00C00C00C00C00C00C0C00C00C00C00C00C00C00C00C00C00C00C00C00C00C00C00C00C00C00C00C00C00C00C00C00C00C00C00C00C00C00C00C00C00C0C00C00C00C00C00C00C00C00C00C00C00C00C00C00C00C00C00C00C00C00C001
100C00C00C00C00C00C00C00C00C00C00C00C00C00C00C00C00C00C00C00C00C00C00C00C00C00C00C00C00C00C00C00C00C00C00C0C00C00C00C00C00C00C00C00C00C00C00C00C00C00C00C00C00C00C00C00C00C00C00C00C00C00C00C00C00C00C00C00C00C00C0C00C00C00C00C00C00C00C00C00C00C00C00C00C00C00C00C00C00C00C00C001
100C00C00C00C00C00C00C00C00C00C00C00C00C00C00C00C00C00C00C00C00C00C00C00C00C00C00C00C00C00C00C00C00C00C00C0C00C00C00C00C00C00C00C00C00C00C00C00C00C00C00C00C00C00C00C00C00C00C00C00C00C00C00C00C00C00C00C00C00C00C0C00C00C00C00C00C00C00C00C00C00C00C00C00C00C00C00C00C00C00C00C001
100C00C00C00C00C00C00C00C00C00C00C00C00C00C00C00C00C00C00C00C00C00C00C00C00C00C00C00C00C00C00C00C00C00C00C0C00C00C00C00C00C00C00C00C00C00C00C00C00C00C00C00C00C00C00C00C00C00C00C00C00C00C00C00C00C00C00C00C00C00C0C00C00C00C00C00C00C00C00C00C00C00C00C00C00C00C00C00C00C00C00C001
100C00C00C00C00C00C00C00C00C00C00C00C00C00C00C00C00C00C00C00C00C00C00C00C00C00C00C00C00C00C00C00C00C00C00C0C00C00C00C00C00C00C00C00C00C00C00C00C00C00C00C00C00C00C00C00C00C00C00C00C00C00C00C00C00C00C00C00C00C00C0C00C00C00C00C00C00C00C00C00C00C00C00C00C00C00C00C00C00C00C00C001
100C00C00C00C00C00C00C00C00C00C00C00C00C00C00C00C00C00C00C00C00C00C00C00C00C00C00C00C00C00C00C00C00C00C00C0C00C00C00C00C00C00C00C00C00C00C00C00C00C00C00C00C00C00C00C00C00C00C00C00C00C00C00C00C00C00C00C00C00C00C0C00C00C00C00C00C00C00C00C00C00C00C00C00C00C00C00C00C00C00C00C001
100C00C00C00C00C00C00C00C00C00C00C00C00C00C00C00C00C00C00C00C00C00C00C00C00C00C00C00C00C00C00C00C00C00C00C0C00C00C00C00C00C00C00C00C00C00C00C00C00C00C00C00C00C00C00C00C00C00C00C00C00C00C00C00C00C00C00C00C00C00C0C00C00C00C00C00C00C00C00C00C00C00C00C00C00C00C00C00C00C00C00C001
100C00C00C00C00C00C00C00C00C00C00C00C00C00C00C00C00C00C00C00C00C00C00C00C00C00C00C00C00C00C00C00C00C00C00C0C00C00C00C00C00C00C00C00C00C00C00C00C00C00C00C00C00C00C00C00C00C00C00C00C00C00C00C00C00C00C00C00C00C00C0C00C00C00C00C00C00C00C00C00C00C00C00C00C00C00C00C00C00C00C00C001
100C00C00C00C00C00C00C00C00C00C00C00C00C00C00C00C00C00C00C00C00C00C00C00C00C00C00C00C00C00C00C00C00C00C00C0C00C00C00C00C00C00C00C00C00C00C00C00C00C00C00C00C00C00C00C00C00C00C00C00C00C00C00C00C00C00C00C00C00C00C0C00C00C00C00C00C00C00C00C00C00C00C00C00C00C00C00C00C00C00C00C001
100C00C00C00C00C00C00C00C00C00C00C00C00C00C00C00C00C00C00C00C00C00C00C00C00C00C00C00C00C00C00C00C00C00C00C0C00C00C00C00C00C00C00C00C00C00C00C00C00C00C00C00C00C00C00C00C00C00C00C00C00C00C00C00C00C00C00C00C00C00C0C00C00C00C00C00C00C00C00C00C00C00C00C00C00C00C00C00C00C00C00C001
100C00C00C00C00C00C00C00C00C00C00C00C00C00C00C00C00C00C00C00C00C00C00C00C00C00C00C00C00C00C00C00C00C00C00C0C00C00C00C00C00C00C00C00C00C00C00C00C00C00C00C00C00C00C00C00C00C00C00C00C00C00C00C00C00C00C00C00C00C00C0C00C00C00C00C00C00C00C00C00C00C00C00C00C00C00C00C00C00C00C00C001
100C00C00C00C00C00C00C00C00C00C00C00C00C00C00C00C00C00C00C00C00C00C00C00C00C00C00C00C00C00C00C00C00C00C00C0C00C00C00C00C00C00C00C00C00C00C00C00C00C00C00C00C00C00C00C00C00C00C00C00C00C00C00C00C00C00C00C00C00C00C0C00C00C00C00C00C00C00C00C00C00C00C00C00C00C00C00C00C00C00C00C001
100C00C00C00C00C00C00C00C00C00C00C00C00C00C00C00C00C00C00C00C00C00C00C00C00C00C00C00C00C00C00C00C00C00C00C0C00C00C00C00C00C00C00C00C00C00C00C00C00C00C00C00C00C00C00C00C00C00C00C00C00C00C00C00C00C00C00C00C00C00C0C00C00C00C00C00C00C00C00C00C00C00C00C00C00C00C00C00C00C00C00C001
100C00C00C00C00C00C00C00C00C00C00C00C00C00C00C00C00C00C00C00C00C00C00C00C00C00C00C00C00C00C00C00C00C00C00C0C00C00C00C00C00C00C00C00C00C00C00C00C00C00C00C00C00C00C00C00C00C00C00C00C00C00C00C00C00C00C00C00C00C00C0C00C00C00C00C00C00C00C00C00C00C00C00C00C00C00C00C00C00C00C00C001
100C00C00C00C00C00C00C00C00C00C00C00C00C00C00C00C00C00C00C00C00C00C00C00C00C00C00C00C00C00C00C00C00C00C00C0C00C00C00C00C00C00C00C00C00C00C00C00C00C00C00C00C00C00C00C00C00C00C00C00C00C00C00C00C00C00C00C00C00C00C0C00C00C00C00C00C00C00C00C00C00C00C00C00C00C00C00C00C00C00C00C001
100C00C00C00C00C00C00C00C00C00C00C00C00C00C00C00C00C00C00C00C00C00C00C00C00C00C00C00C00C00C00C00C00C00C00C0C00C00C00C00C00C00C00C00C00C00C00C00C00C00C00C00C00C00C00C00C00C00C00C00C00C00C00C00C00C00C00C00C00C00C0C00C00C00C00C00C00C00C00C00C00C00C00C00C00C00C00C00C00C00C00C001
100C00C00C00C00C00C00C00C00C00C00C00C00C00C00C00C00C00C00C00C00C00C00C00C00C00C00C00C00C00C00C00C00C00C00C0C00C00C00C00C00C00C00C00C00C00C00C00C00C00C00C00C00C00C00C00C00C00C00C00C00C00C00C00C00C00C00C00C00C00C0C00C00C00C00C00C00C00C00C00C00C00C00C00C00C00C00C00C00C00C00C001
100C00C00C00C00C00C00C00C00C00C00C00C00C00C00C00C00C00C00C00C00C00C00C00C00C00C00C00C00C00C00C00C00C00C00C0C00C00C00C00C00C00C00C00C00C00C00C00C00C00C00C00C00C00C00C00C00C00C00C00C00C00C00C00C00C00C00C00C00C00C0C00C00C00C00C00C00C00C00C00C00C00C00C00C00C00C00C00C00C00C00C001
100C00C00C00C00C00C00C00C00C00C00C00C00C00C00C00C00C00C00C00C00C00C00C00C00C00C00C00C00C00C00C00C00C00C00C0C00C00C00C00C00C00C00C00C00C00C00C00C00C00C00C00C00C00C00C00C00C00C00C00C00C00C00C00C00C00C00C00C00C00C0C00C00C00C00C00C00C00C00C00C00C00C00C00C00C00C00C00C00C00C00C001
10PC00C00C00C00C00C00C00C00C00C00C00C00C00C00C00C00C00C00C00C00C00C00C00C00C00C00C00C00C00C00C00C00C00C00C0C00C00C00C00C00C00C00C00C00C00C00C00C00C00C00C00C00C00C00C00C00C00C00C00C00C00C00C00C00C00C00C00C00C00C0C00C00C00C00C00C00C00C00C00C00C00C00C00C00C00C00C00C00C00C00C001
100C00C00C00C00C00C00C00C00C00C00C00C00C00C00C00C00C00C00C00C00C00C00C00C00C00C00C00C00C00C00C00C00C00C00C0C00C00C00C00C00C00C00C00C00C00C00C00C00C00C00C00C00C00C00C00C00C00C00C00C00C00C00C00C00C00C00C00C00C00C0C00C00C00C00C00C00C00C00C00C00C00C00C00C00C00C00C00C00C00C00C001
100C00C00C00C00C00C00C00C00C00C00C00C00C00C00C00C00C00C00C00C00C00C00C00C00C00C00C00C00C00C00C00C00C00C00C0C00C00C00C00C00C00C00C00C00C00C00C00C00C00C00C00C00C00C00C00C00C00C00C00C00C00C00C00C00C00C00C00C00C00C0C00C00C00C00C00C00C00C00C00C00C00C00C00C00C00C00C00C00C00C00C001
100C00C00C00C00C00C00C00C00C00C00C00C00C00C00C00C00C00C00C00C00C00C00C00C00C00C00C00C00C00C00C00C00C00C00C0C00C00C00C00C00C00C00C00C00C00C00C00C00C00C00C00C00C00C00C00C00C00C00C00C00C00C00C00C00C00C00C00C00C00C0C00C00C00C00C00C00C00C00C00C00C00C00C00C00C00C00C00C00C00C00C001
100C00C00C00C00C00C00C00C00C00C00C00C00C00C00C00C00C00C00C00C00C00C00C00C00C00C00C00C00C00C00C00C00C00C00C0C00C00C00C00C00C00C00C00C00C00C00C00C00C00C00C00C00C00C00C00C00C00C00C00C00C00C00C00C00C00C00C00C00C00C0C00C00C00C00C00C00C00C00C00C00C00C00C00C00C00C00C00C00C00C00C001
100C00C00C00C00C00C00C00C00C00C00C00C00C00C00C00C00C00C00C00C00C00C00C00C00C00C00C00C00C00C00C00C00C00C00C0C00C00C00C00C00C00C00C00C00C00C00C00C00C00C00C00C00C00C00C00C00C00C00C00C00C00C00C00C00C00C00C00C00C00C0C00C00C00C00C00C00C00C00C00C00C00C00C00C00C00C00C00C00C00C00C001
11111111111111111111111111111111111111111111111111111111111111111111111111111111111111111111111111111111111111111111111111111111111111111111111111111111111111111111111111111111111111111111111111111111111111111111111111111111111111111111111111111111111111111111111111111111111